10x10* xoq
****o*****
*        *
**       *
*  **    *
*    *   *
***      *
*  *   ***
*     ** *
* **   * *
****q*****